##################
#### ##  ##     E#
#### ## ### ######
#### ## ###   #  #
##   #  ##### ## #
#### # #####     #
#### # ###   #####
#### # ###   #####
#                #
######## #########
#S               #
##################